254 20 20
# #  3  *  #    *  *
   1* # * 2# *** *1 
*   *#  #  #   # *  
   * # *#  * **  * #
 ***#    # *** * *  
 # *  * 3*      2* 3
**3 #  * *** *    # 
   **      *2  #   #
 * #   3 #*  #   *3 
p  * ### * *# * #* *
   *# * #        * *
* ###2 *    3*   *  
 #*** * *  # # *   *
#    *   **  **   * 
* 1  #*  1   * #### 
    #*  *  *  #  *  
 1 *** #  * 3** *   
  *    * 3 *   #  * 
 *    *  ** #**  3 #
* 2 # * **    * *# #