27 20 20
 *   *  * * * *   * 
#  #  #  #   #   *  
*   *          * * #
*  ** * 2*#   2 **# 
**  * *     *#*    #
*  * ##*# * *  *  * 
    #* * #  ******  
* 2   ** # **   #*  
*   *  ** 1 *#* # # 
*  * ##  #  # #**   
  #* **   ** 3 # #  
    *  #*2 *#*  #* #
2 *           #* *# 
  #*#     ##3  #   #
  * *p *     *      
      **   **# **# *
*#    *  *  * ##    
#*#  1*   * *  *#* #
          *    *    
 #   *  *   1  *****