61 20 20
 *   *  * 2    *#*  
#***  2* *  *      #
# *    *# *  *#* ** 
 # #  **##   ***   *
#* **  **   *  *#   
 #3    *  2 *   * **
    1 * *  *  *#   #
#** * * #    *  p   
  * #    **2  **   #
   # * *        * * 
*# * *   #1 *  #*  *
 *** *# 2    ##*#** 
#      # ***#*  #*  
    #*1  #   3 # #  
   #       #     #  
#    *** ****     # 
   # #*  *  *#   #  
 *      *     *   * 
***      ## * ***  *
 # #* ** * * # #    