685 20 20
      *  *# **#*    
 p  *        # 3 ** 
#  2# 1 *  *# * ###*
*   *    2# *  #  2 
* * ** *  ****2    *
 **    3 ###*    *  
    *#*  * * 3# 1 **
  ** * #*  ##       
  * #  #* #  *  # # 
 #  ** #   *# 3     
3 *     3*  #** #* 1
   3** *  *# *  *   
  * #  3 # # * *  # 
 #*   # #  # # * * *
 *  *     *    * *3 
 ***  **   *#**     
# 1 *#* # #    **   
**   *** 3 * * 2  * 
###* #*   *      1#*
* *** ***      *#   