67 20 20
 * #***#*  ** *  ** 
 #        1      ** 
#  2    #* # #  #   
 ** **** #***# 2 #  
#* *  *   * # ###   
    *   * #* *#*#* *
 * **   #*  # *  ***
 #*   *  #      1*  
*    2      3  *   1
   ** *   *   #**#* 
  *  *# 2       * **
 #   ## ## *** *#   
 #2   **    * * p   
 *   # #*   # #* ** 
*  *****   *  *  #  
 #*    *##*     ** *
# *#*   #        3 #
       *     *      
# **** #*  ##* *    
       *    *    *#*