34 20 20
   *   # ##  * #  **
  p    *   3 ##   *#
**  # ***2 *#   *   
        #    * #    
   *       ** * *   
      *    #*# #  * 
  ** 1 ****#*    # #
  # ** *  * *# 2 *  
 **    #*   *  #  * 
 *  ##*   * *    2 #
## *  * 1    # ** * 
** **   *    * * *  
*   #  * 2#  #   # *
*  *#** *  *    *  #
# #      * #  #     
*  **#***#  ****1  *
 3     **  ## #* *  
  ## **  *  2  *  **
##    *  *   * ***  
 * ***# ##   *#     