892 20 20
#*# ** * # 3 *#  *  
      3**     # #*  
 * 3**     **#*  *# 
    **#*##   *# *   
# 1        #* *     
* * **#**#  * *  p**
  ** **** * ##* *  #
*## 1    3     2 #* 
 *#*#  *   *        
2     * # 3   3 * * 
   # * #**   #  *  3
 *  * # 3  *2 *   * 
 # 3   * **# **# # #
 * *   * #* # **  * 
  * * * *#  # **   2
*#   * # *   *### * 
*    **   **1 #*  # 
*     *#* *  *     *
  * 3  * 2  *   * 1 
  #* #      #  1 #  