1 20 20
p   ##  ##*       *
  1* *** * *        
    *###   *        
   * * #  **** *  *#
    1# * * * #*   *#
*#   * **  #    #* *
 # *   **  *   #
  * *1 * # *  ##* #
        # ***    * *
# *** * *   ***  ## 
 **  *  *  * *   **
 *    #   *      #  
 * *    * *  *# *** 
*#   #*# **##### *  
  **#        *# * # 
 * # * * #       * *
* # * #** *     *   
   #  *    #  #  * #
 * *         * * * *
*          ## **   #