36 20 20
  *  * #   ** *     
*  *2 *       * *  1
* **   *#  ### *  * 
  #    #  ** *#   1 
*  *# ** * 3  #     
  2* * ## * #  ***  
     #  * #  * * ** 
*# *   **  *   ### #
 *  2   *     ##*#  
 *#* * *#      *  * 
#  # #    ***    ** 
#*  2*  *     # *  #
 *#     1 *#*  * * #
# * **    ** # * *  
     # ** #*  **   *
    #   ** *    p   
# # * #**##   *  ***
     * * ##  2 **  *
* #   *      *# *   
# * *    **  * 3  # 