339 20 20
 #   *    *   * * * 
#  *  **#*   ** *#  
* #*   *#   ** 2#* #
***  ** *# *  *  1  
* # *#       *  *   
        #* # #3  *  
  3  3**#* *      * 
* *   * 3  #  # * * 
    **   *  1  *** *
* ** 3 *###*# #**## 
** #  ##  *  **    *
 **  *    #**   2* #
3 * 1  * 2    **  # 
   #*#*     *  3  * 
  1*   3  *#    # * 
    # ** *   2 # ## 
   3  p      *  ** *
 *  #  ###*#*#**#  #
  #* 1 * 2   3 **## 
    * *   * * # *   