24 20 20
        *   2    * *
   2   #     *     *
#*# #*    ##   *#   
  ## *# p*   *#   * 
    **   * #    *   
 **  * #  1 **#  ## 
  * * *#** *#       
        * **  * *** 
   # #*#      *#**#*
     ## * # **     #
2  *#**  *   ##*    
 #  *  *3 *      * 1
 ***#  *  #  **   * 
  *  3 * *# *# ** * 
* *  *# * ** *  *   
 2 **  1# * #  # #* 
 * #* * ** # *  * #*
**    # #**    2 ** 
 *  #    * *  #*#   
   *# **     #  *  *