71 20 20
     #*# *#  *   # *
#*  ** 2   *p     **
* *  ## * #    #*   
    ## ##    #*     
 3  *   ** # ***#  *
#**** #   *#   #    
**  **# 1   1   ##**
#  *   *     *  * * 
  2 # *# *  *  #* * 
     *  *  ##*#     
1 ***  # #  **** # *
  **** ****     2   
    ** #  * **   *# 
***2 * *#  #*   #   
      #*    #*   * #
 #* *  #       2 #* 
3       *       *   
    * * * * * *# # *
#* ** #  * *  * #   
    #  *    * *  ** 