73 20 20
 # # #*       *     
  * # *    * # ** **
# * ##       *      
 2**   #  #   2*    
* ****# #  *   * *  
* *##  **   **#   * 
  *  *#   #  *  * # 
 *    *  1* * ** #  
**   *#     * * * **
*  #  ## *     #*** 
#*   *  *  * p** ## 
 * *   *#* *     *  
3     # 3 *  *  **  
  1##  * ***  *#  *#
 #  * *  *       *  
 *  #  # *    2  #  
 2 ****##   # # **  
*  ** # # #  2*   * 
 #*   **   *#  1 # *
   ** *   #     *## 