82 20 20
  * ****# *  ### #  
    *  *     ##* * 3
**#* * * 2  # *  #  
*  p  #   *#    # * 
        *# *#      *
* ##*#** #** 2   ***
*** *#   *     *    
 *  ** *#** ***  ** 
 * *  1   *## #  #  
 ##   #  *     *#   
  * *    *  * ** #**
 * #  # * 2    *  **
*  *  ##*  *  2*# # 
  *#* #*   * * **   
  #  3***  1      **
*     * 2      #    
* #    *      #*  * 
*   ##        * *  #
 # *       *  *  *# 
#  #   1 *  *   *# *