161 20 20
# #  3 *#   **  #** 
         ****#*     
 p# 2# ****### *  #*
   * **     #*  *#  
 * *#    1 # #* ***#
 # * 1 *    2  # *  
   #* * #  #    *  *
 *  #     * *#  #*  
** # 1       # *#* *
*  *  * * *   *#*#  
   3  #*  *# *  * 3 
3       *2 ***  2 *#
 **  #* *     1  *  
# *  * 3* **   *  3 
  * #*   2  3# *    
 **3 * **       # #*
#   # * * *# #   3  
  * 3  1    *  *# **
*#   *  ***  ***#   
   *  #     **## #**