92 20 20
*  #  * #   * *# # *
 2  * * * *#  **  * 
# * *  * *   1 *   3
***  ** #   #* #  * 
   2  **   * #     *
    * * **  ##  3   
 2 # *    #    #  * 
#* ##* 2# # *  *  #*
**   *#   ***  ##* *
 *  1 * # *#  **   *
  # **  * *    * *  
#     *  2       #  
 * * *      *#*   # 
*    **  #** ******#
 *   p  *      # *  
      *#  1    * #* 
*#*     *    #     *
* * #*     * *  ##  
 #*  ##    #*  * *  
  # # * #   ***# #* 