78 20 20
    *     ##   # ** 
*  ** #   #   *   * 
    ** *   #**   1# 
        *  **  #*   
** p#  **  2   #* **
 #    **    * #**  *
 *#  * ** * *  # *  
 * #* #*  #2 #**** *
  #*#  2  *   *   * 
# #  *  **    #     
 * * *** ****#   *2 
* 1# # #   #       *
     *     *  *  #  
*      *  #* 2      
 ***#*   * #  * 1  *
#* # **   *#* #*   *
 3 ** *  #   # *### 
#  *  * # ** *  #   
 *# * #  3 * #      
 #   #  * #*  **    