589 20 20
#  * 2 #*#  ***##  *
*   #  *##**  ** #  
 #  *  # * *3   # **
   1  #  1         #
2   *     ***#  * 1*
 #  * ***  1   *    
  2  *** #   # *    
 *     * * * ##  3* 
 * * 3 *#*   ##   ##
   *  *   3    #*  #
 1*## *** * #** *   
  *** *#*# * 3 **# #
**# * *  #2 # * *  *
   3  #    *  *#*   
 3    **    *  # # *
**##*   p *  *  3** 
* *  3    *   *  *  
       # 2***   ** *
*  *#      ##* # *  
  *   * * 3 # *   # 