43 20 20
  ** #    *   **#   
   ##   # *  # * *#*
#*   # 2    **** #  
  * 2 *  ** **   # 2
*# #*     **#   *## 
    # *       *#   *
#* * 3  #   # **# # 
  #  ## **# ** *#  *
   **  *   ***  *#*#
    *** 2  # #*  p #
  *  *  * **#* #    
# * *        *  #*  
 *  **  * 2 ** * # *
    **1   *    3   #
 * *       #     #**
  # *#      **      
  * **1  # ***** 1 *
     #    **   **   
*  **** *#   ##  *  
             # #  **