49 20 20
      * #    *## #  
  *#    #  *3  #  *#
*  *# *  * * *      
*#* #* ** 3 ** * ** 
 **#**   *#** ##* #*
  #  *      *#   2#*
* * *# * ** *  *    
#   * # # *  *  **# 
*   #    *    #   # 
 * #****2       #   
  *      *## **#  # 
  **   * * *## * *  
 *    1 *  *      *#
 #   *   #   *   # #
**  #  *  **   #*#**
 *      2    *     #
 2  ** *##* p * * * 
  *2 *  ****     1* 
*     1  *          
    #  * * # #  * #*