882 20 20
  * ## **#  ## 3    
*#   *   3       ** 
##    # * # # 1  *  
 *  1 # *  1    3   
*      ****  3*   3*
  * * **    * ** *  
 *# #**  *  ***  ** 
   #  * *# #  **#*  
 ##  3* ***  #  #   
** ** ** *  3  p    
   ***  2*# *    2  
  * #**  *#*  *  #  
   #   *#*# * *#* * 
   * # 2   * *  * **
*#    *  # *1 *## # 
*  *  **        *#  
 #* # 3 **   1#   #*
3 # #      *  #  2 *
 **# * 3  2 *#* ##* 
*   *   ***  ##     