25 20 20
#*  ###    *  *# # #
  * *     *# # *  2 
*2 *  * **  2    #* 
  ## # #  *   * *   
#* #* **#*  # 2     
# * * *  *   *    **
 * *#   * * #       
*  #  **      * ** *
* *    **##    * *  
 ** * ** # *  #   * 
     *  *     #3 ## 
 *  *   * #* #* *  *
* *  *# #3   * *  * 
   #   *  ** # # * #
*  *  # **  **## * *
  ##*       * 2     
  * p   # *    ***  
       * * *  *  #* 
 1    # #*  #*  1  1
   #** ** #   *#**  