12 20 20
*   *  ##   *****#*#
     *#  * *# * *   
##    #  **#* *  * 2
*  * #         #2 * 
   ***   *#*#     * 
*  2   #  * 2       
 *#   * *# *  * *   
   * #  *###**  *#  
     * * # #* 3  #  
  * #  * * # #  *   
# * *   *   #   #  p
 #   *  *1     1    
 *     #*  * ##* *# 
* *  *# *    # *   *
  ** ** ***# *      
 2 ** # 3     *# * #
 *  **    *** ## *  
*#  *** *  ** ***   
#        *     1 ** 
    # *#*# #* *  *  