37 20 20
* # *# #   # #  * #*
*  #  ** *      1   
*  # *  *# *  **  * 
  * **   ** *  *   *
*   *#* p #  # #2   
       *  2 **   ***
** * # *     #* * # 
 # ***#* 2    #*    
*  * *  ****  ** *  
 *   # 3** # 2* #* 1
 #*#  * **  *  *    
   #*  #  *#  #   * 
     #  # #* 2 *   *
 #  * #  *  ##  # **
  *      * 3 #* #** 
 * * #   ** ##  #   
*  *       *  ****  
   # #* *    # # #  
  1* *       ** * # 
     #*   *#    *   