20 20 20
  #*# * *     * **  
  #*  ##   2    *# *
*  #** * *#    *   #
  #  * *  * *       
   ** *#*   #   *** 
* *#      *#  ##*** 
*  * * 2*    #  * 1 
 ###    *  ##  3*  #
  *  *       #* *  *
       ***      *  *
 **   3  ** 2** **  
      **#  # *# #   
 ## #   * 1* *     #
    **   *   ***    
 *     #   1    # **
  * # * * * # *    *
*    #**#*#  ** *** 
*      ##   * *    2
**# **   *## p *2 # 
*   ##  * ##**#     