387 20 20
 # *  * *   *    *  
 *  *#   *  3  #   #
* #  # 3 **# **** 3*
*   #  #   * 1   * *
  *3 #     *  ##   *
 2  * # 1 #*    * **
    **  ** *#  *    
# *   **  * #*      
  **** **# #* # 2 # 
1   **3       **#  *
   3 *   * 2 *# * # 
*# * *  #**   #  #**
 *#  * 1*#* 3 *   # 
        *   ***#  **
# #*2  #  * *   #*  
 **   p## *  1 #  # 
** 3 *   #      *  *
 #  *   * 3    #*  *
  3  ***   #* 2*# * 
**  #  #* ##   **  #