250 20 20
 3 *  3 # * *   * #*
*       #* 1 ** *   
*# 1 * **#   ** *   
* #* 1 *   * #  #* #
* p   # 2 * 3* #  3 
    #  ** *  **   * 
**   *  #3 * * 2#   
  3 * * # #** *   # 
 *       *    *  #* 
1   *# *** *  * # 2 
   * #*     * #  # #
 #** * #*# *   3 *  
 #*  1  *  ** **# *#
 * #   *    ## *#*# 
 * *    # * #*   *#*
   *  # *2      * * 
*# # *    #**# **   
**3 *  #*  *  #  #3 
    **      *   2   
*   # 3 *   * ##* *#