719 20 20
  **     ** #    ** 
  * 1***  # # *3    
 *** *# *  * 3# *# *
#  *# * *  1    *   
*1  *    *#   *  #  
  *  p    * #*   3 *
3        *  * * *  #
 ** * *3    *   *** 
   # *  #* #* #3 *#*
  *   #  3 ##*  #   
* # # * * * * 3# 3* 
    #*   **  #  #  #
2 *1  * # *  #*   * 
  * * 2  ###** #*   
 *  *  *   *    #1 *
 ##  *  *#  #*#*# * 
*  ***  **      * *#
   *  3 ##*   ** 2  
      # **#* 2 * #* 
 #  #* #     ** 2  *