285 20 20
#**    *  # * 2  *  
   #* 2 #3  ** *    
#   *  *# *  *  *1 #
*    *  *  *  # * # 
 #    p *    #   *  
** *  ##*  #  *  *#*
*   *   *#*   # 2** 
  *  * 1      #* * #
1 * ## **** #  2  * 
 * *##3 ##  *   *# 3
 *   # *   *   #  # 
#  #** *#    *#*  * 
# * * #* #***  #  **
*  ** *  #   #** * *
  *  *  #        *  
  2      *3 * ***  #
 *  * 1  #  # * # **
3 **     3   * 3 *# 
 * *3 *1   3****    
#*   *  #   # #  3 *