3 20 20
 ** 2 #* *  ** #    
  *  *   *#* ##     
  * # #  *  *   *   
#*** * * p     #** *
 * # **   * #*# *  *
# *          #**  #*
    *#*** ** *##   #
## *   *# *      #  
#         * #1 # 1 #
    ***    #      **
#  *#*#   **#   *  *
     ****  * *   ** 
*  #       ** #**   
  # *   *  *  #*  *#
 **   # ****      #*
**# **  #    3  *   
   1     *     *    
 *     * 2     # *#*
      # * #   # #*  
***  ##*  *# **     