32 20 20
  # 3 * #  ##      *
     # # 2  *  *   #
   #  **      ** #* 
 *** *      **     *
 #   1    #*     1* 
    #  ##**# *# *   
* ** #    2  **     
 *  ** * * *   * *  
  # #* *  **  *  *  
  **#     *#* #* #* 
# # *#1  *   ***   *
**  #     **# *#**  
#  *#*##* **     *  
#   *   2   * 2 * * 
     * # * *** #  3 
 *** ###        #  #
** ## *** 2*      #*
*  p # *   **** *   
    *#* *    *   *  
   ##   *  *#   * # 