99 20 20
 3  **   *  * * * * 
   *  #*     2 # ## 
 * * 3 # **     *#  
# * ***  *  ## #****
  # **   2  * **  # 
 2**   ##  #   * #  
   ## 2***  #  *#  *
  *  # **  *     *# 
   #   #* * 1#  # *#
    #     *     #  #
 #*  *1 #**#   ***2 
    *  *      * #   
  # * #* * * #*  #  
    *  #* ** *      
  *  * *   p *  * * 
 *   **       # ## *
****#* ** *  *  *** 
**   #    *  *  **  
#  *  #     ** #*## 
#   *   * 1  *      