29 20 20
*  *  *  **# * *** #
  *      *** ## ##* 
   * * *    *   ##*#
*    #*#*      #    
#    **     2 *  *  
  #*  # *#*   #2 *  
3 *   #  *       *  
   ** #       2  *#*
***   # *  * #   3 *
 *  p*# * 1    1# ##
   #    #  *##  *#  
  * ** 2   *   *#   
 *    #* *2     *# *
*** ***  #  **  *   
 ##     *    #      
 ***    * # #*    * 
 #**  #  *  *    *  
**#**  ***#*# *  #  
   # #  #*#  * 1  * 
 ****  *  *   *  ** 