41 20 20
 **    *           *
 * #**   * *** # 2  
  *   1  * #   *#  *
*    # *   ***      
  1 * *  # * # 3** #
 ## #       * #  ***
**###*** * * *# 2 * 
    ##    ** #    * 
*  * * 2  * **      
    **   #    #* *  
  #** *#  *2  *  #  
#*#   *#  *     #  *
 *   *  #*  1* * 2  
 ** p ** #** * 3    
***  *#    **##  # *
    #  #  #   * *   
 #**#  #      *  **#
*  ** * *# # *      
#  #   *# *     * * 
*#  #    *   #   **#