45 20 20
 #   2 *   *   * * *
  *    #  *##  * *# 
*       #* ** *   * 
 # **#  *  *## *  * 
*#  ** # 1 *  #   * 
#* 3 # #  *  #*# *  
   *##           *  
    1 ##*   # *2   #
*         * *   * # 
 * **  2 *#     *   
   **# # **      # p
  *   #  1  *    *  
*#* # * *    #  # 3*
  *  *  ##   * *   *
#  2 ** # *** #*****
 #   *   **   #*  # 
#*   ** *   *  # ** 
     *   ** *#*  #* 
 * # **2 # *  * *# *
 *      * ** #   * *