72 20 20
  ##** ##      #  *#
 # *     **  *  **  
#** *  * *  *  * # #
 *  #*  #* # # #* 2#
 * *#    *    * *   
  *  #  *  # ** * * 
# **  *   #* *    p 
*   * 1  **  #  #   
 #  #  *    2     * 
# 2  *  ***# * * 3 *
 * *     *  *   *   
*# *   *#  1* *  #**
 *  *    1* *      #
  *         **   * *
  #*  ** *  * ##*   
  #   *    ##   ** #
#*  ## *  **    *#**
 * 3 #2  #   # 2  **
* # #       #    #  
* #* * **     * ****