60 20 20
 2 *     ##*   ***  
  * ##* #*# *      *
#***##   *  #  ##*  
   **  * ** #  *# #*
**    1* * *    p **
  *          #*    *
#** 2  3 * ** *****#
#   *  #  ** # *    
 * # * *   ** #     
 # * # **1  * *  #*#
* ** *  *    2* # 1 
 *   #*   * *       
 # # * **2      * * 
 **     #  *#  ## * 
  2  #*## * #*     *
       *#*  #  # # *
*    *  **    *   *#
* #        * #      
 * ##* ** *    3 **#
  #   *           * 