171 20 20
 3 **  # * *  *    #
  * # 2**    *  1   
  *    * p***  *## 2
*1  *#       #*     
   3 ** * **#  3    
*  *  *   ** * *    
* 1    #* #    #** *
*    1  *   * *#  3 
#    *# *##  3  *  #
**#* *  * ** **  *# 
** #*    #   ** 3 # 
  **#      *# 3  ## 
 #*  *   * # # *   2
   *# 3 *  **   *#  
2 *  * * #* *# ** #*
  *  *  ** #* * *   
*  *  # *# 3    *   
 *  * #*# *   #**#  
3 *     ### # ## *  
 # 1 # 2 *   **   *#