90 20 20
   * 1   *# #  * ** 
*1  *  # #***   3  #
* * # *#   #*# * ** 
* *  *  * #* #     #
 p *#  # *     #  # 
#  #  **2 *   *     
  * **   * * *     #
  2  * **##  #    * 
1  * 2   *    #  * *
 **    * #**  ##    
 *   # #* *     *   
 ***#  * * # **##*  
  * *        *# *#*#
  * *  #  *#*  *  * 
**# *** 2  *   *    
 #   ** #*  3       
 *      #** *   #   
*** * #*# *  ***  **
       #  #*#    *  
#* *  *# #    2     