11 20 20
 *#*   *#  * * #**  
#   p   ** *  *#    
#**  #*#** ##   #  *
* * *#**# #   *  #  
 #   **##*#    2 *  
 **   # 2  **  *    
#* **    #  #  *   *
** * * ** *     *# #
   *   *   ## 2  3 *
* ## #   #*   # * **
  ** *  ** * * ** # 
  *         * *# *  
 # **#  #  2*  * *  
  #    **     #  1 #
 *  *   **    #   #*
   * # * *    #     
  *  **   2 *     3 
 1  ** ##  *    * *#
#     * **#    1 *# 
***     ***         