8 20 20
*  # #    **   *   *
  * 1    #*  * *##**
#*     #  ** ***  ##
 *  *   #    #   ** 
## #* * ** *#  #* * 
    #   # * *  3  * 
 *# *#  **    # **  
 ** *  2* p  *    **
   *#     *  *  *#  
 2*  #    ##  *  # #
   **#   * *      **
*      #*  *  ***#**
  * #*  **  *  #   *
     *#  **   ##    
  2 *  # **#**  #   
 *# ****#     2  #* 
 * 3### *   *    #  
*       ** *    #  *
       #    1*     *
**     **#     #*  *