80 20 20
 #  * *  **##**     
  ***#      #*     #
#   #  # *#  #*  #  
 p * * *  #*   *  * 
 *   *  #   **     *
   **  ***  # ###   
* * #*  * # ##    * 
 2  * #2   *     * 3
 *# *#* * 3 * #     
  *   *## ***  * # #
 *** #   *# *    **#
   *   **    1*  *  
  #*#         *# ***
 # *** *  #* **   **
# 2 **  *#  *   * 1 
 *   **   *   ##    
     *   #     *  * 
  1#*##    **  2  **
 #    ** * * **     
 *    #   * 2 # *# *