379 20 20
 ###**   *#*       *
*    **2 *   *# * # 
# *        ## * #3 *
*   #** 3 # #     *#
 ***   *#    #*  * #
#     *# # 3  *** * 
  1  * ** *  ***  2 
 * *  2 *   # 2 *  *
   *  ***  1   * * *
  3 ** #*   #**     
*   ###  *   *  3* *
   *   #**    *  *  
 *  * *  #  *  *  #*
   *     3   3  #  *
*# 1 **p    *  1## #
**    #   3 # # **  
 ## ##* 3    *    **
  * #* * #***  #**# 
*  * *1 *# *  *#  *#
 #   *    2 *  # 3  