10 20 20
  2   #   *   **#  #
 * *#* ** *  #** * *
## #****    #*   * *
* * #  **   *  *#** 
#*   * *** # **     
# *   *      # ##  #
   #*#** *2  ** * * 
#   *   #     *# # *
#2     *  * **     *
  *#    *   *  #  * 
1  #1   # #     **  
  *   # #      #*   
    # *     2*  ** #
    *   ***   ## *  
3  * #   * *# **  * 
 **   ** *  #***  p 
**  * #         #   
#    * *1   *#   3#*
 *# *#   *2 ***     
 # * # #         ** 