65 20 20
  * ##   *   #* * * 
 *   *   * #* 2 * # 
  #  # ### * * * 3  
   1  **      *  *  
* ** *#  * ***  ** *
 * #*##   *##     # 
  * ##    * #  *   #
* * * # **  #      #
 1 *   *  * *  ##*  
* *      #****  *  #
 # **   #  *      #*
  2  * * 3  #  * *  
 #   ***     *   #**
1 *p **** *##**     
       * *  2 #### *
    * #*  *     ** *
2 # *#  * *   *  ** 
   *  *#    # **    
 2 *# * #  # * **  #
  *        ** #     