79 20 20
   ##**#   **** # **
*   *##    *#*# #*# 
   *       # # *   *
##   *# *#*     *  *
# 1    ***  **3     
 * *         * *   *
# *   ##*   #   *  *
 3*  *  * ***#  **# 
    *   #    p  * # 
**  # ***** #   *  #
 * 1 *##  #   **   #
 *# * *  2    *  *# 
  *     * * 2      *
 * * * *     ## * **
 2 *      *# **# ##*
   * *# * **#*    * 
#   * #*  *  #   #  
*#*  * #  *2      * 
* *#  *  1   * *2   
           * *#     