837 20 20
 1        ***  * ** 
*  3#* #   * # * #  
 *# # 2 ** * *# * * 
    *  #***  *###  *
* ** #**# ## 1   *# 
*#* ** *   *# #3  # 
        * p**    #  
 #  * 1##* ##**     
    1     #* 2 ****#
 #     * 2* *  *    
*  *  2 *    #   3 *
*2 #**   *# * 1  *  
* #    3* # 3    *  
   * #*  *     3 #3 
 *** #**  *#        
  * * *  #  *  * * 3
 ** *      ****  #  
 *  #  3 #* * *  #  
* ** #    * # #  *##
  ##  3  **  * *   *