46 20 20
 #  **  *      *  # 
 # *#  *   # **  #  
3 #   * * * *    ** 
    1 # #**   #   * 
 ##  *   ** * # #**#
   # # * #*  * *# **
*   **     * * # * *
  ##   2  * *#* **  
   #* ** * #    **  
*       3*#* ** #* *
 *   #** #  **   *  
1  2#   * *  **  * *
  * *  #*p  1  * #  
   ** * * ##*  2 ## 
 #* *   * *  2     #
 *    *#   **    #* 
    #2 *   *  # *   
*  *       ##*   * *
 **   ***#     * # *
         ##     #* #