48 20 20
      *  *#*  #     
 3*## *    **  *  *#
# * 2    *   *** #  
* *  * *  *  *    # 
 *  #       1     *#
  ** *   # #     ** 
#   *  * # 3    *  *
 #   *#         *   
  * *  * *2  #*     
 2* # # *#  *  *  2#
* * # *  #   ## **  
      *   2* *   #* 
  ***  **  *# #**  *
 *# #*   #  *##  ##*
   1  #* *#   *#**  
 *      * ** *   *  
 # # 1 **  *##*#  #*
 ** *** *# *  * #   
**#  *  # # *   *** 
    p   ***    # ** 