42 20 20
  **    * *    #  **
 2  #*#   ## * * #*#
 *  #  * # *   ***# 
** **       #***## *
   *       #   ##** 
* 2** *  * * 3**  * 
      3   * *   #**#
  #*#    2      ##  
* *    *# * * *  * *
* * 2 #   *  #  *   
 #*      *   ##* 1# 
# * #         #     
* ***p  1*  2    * *
 1**  #  ##  #**    
* **    ** * ** *#* 
 ###     * *     *  
 **##* **   ** #  * 
   *   *  # # *   * 
  *# #* * *    #  * 
 *           #  * # 