91 20 20
   **  *   *  *  ** 
# **  * *  #*#   *  
 3     2  ###*3 * # 
* *  # * 1     #*  #
   **  * * ** * #*##
 *  *# **   *#* *   
#*2    #* # *  #    
 *    * * #  #     *
*   *** ** * *#   # 
      **   ##   #** 
 * *#*    ## *  #***
* 1  # **  *   # * *
#**    *    ** # * #
 *** * **  p   *    
1  *# *## **   *   2
  #               * 
 **     *  *  2 * # 
  #* #* # #     * 2 
 *#*    *  **  #    
        # #   #**  #