224 20 20
 2   *#**# #  1     
   *#* # #  3   #  *
*    **   *    3  # 
 #* #*  *      *#   
# 3  ***# #   *#   3
   *#*#*# ***    1  
 3 * *#  *  #*     *
  *      *    * *   
#   *****  #3   *# *
 *# #  **  * #*# #**
 *  #3 # *3 *   *##*
#  *  * 3  *  *  ***
 * **  *  #***#*#   
* *   * **  #*   ## 
#  3 *##*  * * 1    
   **  * 2      #*#*
*  **  2   #p      #
 1  * *    #   * *2 
#  * 2 #** ** 1* * *
  *   #*     *      