5 20 20
****     #  *   *   
  #     *  # # *    
*   *  *  * 3***#2 #
      ##*# #  *    #
    *# **  *  * **#*
 *#*       **  **   
*      * *#    * 3* 
  p *    * ## *#  **
  # ##**** # *  1*# 
*        #**  *#   *
*  *  #  *   2 *   *
  **##*1  *   **   *
  # **#   #*     #  
   *  *# * #*       
**#  #    *  # * #  
 **  *  *#* * *  *  
       ### * *    * 
*2   #     *#   # 2 
  # *  *#     #  * #
*** **** **        #