146 20 20
* #*   **         **
 3 ***    1# ***#*  
 #*   *#   *** #    
 ** 3*  #*#*#    3  
 * *   *  ** # # *# 
 *   **#   #   ** * 
 * *  #      **#    
 * * *** 2 * #*   #*
  1    *        *2  
 ** ** 2  * ####*  *
  ** *  *3   *    ##
# *## #    * **p  # 
*#* #  *# #  *  * **
##    * 3 * *     1 
 *  3      *   *    
 #  * 1** 3  *  2  #
    ##  *  *      2 
3  * * 1  # #***   *
 *#    #** 3 ** # * 
# # 3 *  * #*# #* # 