54 20 20
* ##    *  #   *    
# *#   *     *#  2 *
# **  *  * * *      
     # *    2 *1 *  
 #*   *    # *    ##
  #  #   #* #**     
#*  *    *#   * *   
 *   # #   *** **2  
 2   ##*# *  *2   *#
   *   *    ##  **#*
    ** ## * * **   *
*  1#    #  * ## 1  
    #   ***  *  * **
# 3**#  ** # #   *  
#* * # #  *##*     *
 *# * 3***   * **  *
 *  ## # #    *   # 
#*     * * ** *  * *
* * *     p         
*    **** ***  *   *