896 20 20
*  ** ** 3 ##* p  # 
 *##*         * *# #
     #*#  *   *   **
2  2    *  #* # *   
   * **  #* *  1# # 
 * #   *    2    3* 
  3 #** * #  **   **
# *       *#* 1     
**  #*     #     1  
 * 3  *#* ** *#*  #*
   *  **  * *  ***  
 1 *   *  *  **# ** 
 *  # * #   #    #  
#*3  *   1   3* 3 # 
     # 3  *#   *   *
#*  2 * *  *# 3   #*
** #*  ***#  ***## *
 # **  ***#3 #**    
2 #  ** * * * #* *# 
   # #      # # *   