6 20 20
  *       # *   # * 
  *  #    ** 1   *  
  2 * **#  *  ** *  
**   ** **  *     * 
*#  ***      *   *# 
**2         *   #  *
#*   * *  #* * *  # 
    * # * *  *  *** 
  3##  #  *# #      
*  *   *#   #*   #**
 # #* #      *  * **
* *##   2  # *  * # 
  **  # * #   #* *  
 # * * *   #* *  ** 
 *    # ***   *#  p 
2  * #   #  1 ## * #
  3 *  *  *# #  # * 
* *   #  * *       #
*  #*  # *   *  *# *
*#   *****  # # #   