66 20 20
*         ** *  *  *
  #   ** #    # *# *
  # 2#   * *  # *   
  #*  *** **    ** *
 *    #   **        
*           #   *  #
  * #    2*   2#*#  
*  * #*#            
#* * **   3*#  *   2
 *# *  *#     # *   
 **1  #*    *  *****
 **  * 3 ##* 1   *  
#**   * #     * # * 
# #* *   *# *      #
* #   * #**# **#  **
** *  *#  *#* *  * #
 * # #* # # #p ***  
  #      *      * * 
*  *1 ##**  ** 2#   
*  # *   *#     # * 