560 20 20
 #   ** *  # * #*#  
 # * 3  # 3 #  **** 
#*#**   * *  #*   * 
      2  *    3 # 2 
  #**#  3*** *  ** *
*  **#        # *# *
 **# # 3 #***  #   *
 *# 3# *   * *#    *
 *#* # *  3      2  
p **  #* ### *#  ***
 ** * * #  *#* 3 ## 
    **   1*  **#*** 
  1 *   *  *       #
#* #  ## *    *# # *
 #    1   # 1  # ** 
** * *  * 3   *     
 #  2    # *    ** *
    #   1** ** 2  * 
      *  #       *  
* * **     *#**   3 