121 20 20
  **   * # *  ** *  
   #  **# * # *     
 #    *# * 3     ## 
   ** * 3 ***  * ** 
 1#*  ***  *# *     
*    1 #     2 # * p
#* *    ##*  #* 1*  
 *  ** 2#  #  3     
#*##    #   *  **##*
 1  # **#  * **  *  
*    * * **#  3 *##*
  3 # 2  *   * #    
 *      ## 3* ** *# 
**   * # **      *  
** # 3  * ## #* 3  *
       2** *     ***
*** 2 *  *#*#  1 *  
* 3  ** #    ###  # 
*    # *   #  *     
# #  * ** 3 *    ***