63 20 20
    ***      * # *# 
  **#   # 1 *   *   
* #  * *  ***##** * 
   #  #   * #  * 3  
 ***# * #  *       *
*   *    #    #   * 
    #*#*   3 * #  *#
* 2  **   #*     *  
 ## * *#* #****1  2 
  *  #     *      # 
 *## **# # ***  1  *
*   * * #**#* # **  
#  ** *      *#  *  
    * #  2     #  * 
#* p#  *    **  *   
##   * **#    *     
   * #  ##*   ** *  
#  * ** 2 #     * # 
 *2  * *  **# *   **
      # # *  ****   