864 20 20
  **   *#  # *   ** 
  *  *##** 3 #p    #
     ##   # #  # 1  
#3 *# * * #  *    *#
  * 2  3 *  ** **#* 
*      ****   #*    
 *    *  * ##   ** #
  #  * *  3 # 1   *#
2   *   #         # 
 # #* *  * *  * *# #
  *  3  3 * 3**#* 1*
**#  * # *   * * *  
*  *** ** 3  # *#*# 
  *   1   * 1     * 
#*# #**  * *   *   *
#   2  #* #*  ** *3 
# *  ##  * ** 2  * *
#        2 *      * 
  ** *    * #*#*  # 
**   **#*  #  * 3 * 