59 20 20
#**   *   *#  ** ## 
  #     #** * *  *##
 *  *  *     * *#* #
   #*# #   #   # ***
      **   *  * #*# 
 2 #  * * #**2 * ** 
*  **  2 **     *#  
  1     *  #** * #  
*# * * **  *  * #   
#  *#  *  *    2 ** 
     **  1       *  
*  3* 2   # # ** *  
* # #*     *# **    
#* *  * # #     1 #*
  *#**  #     #     
*   **  *    * * #* 
    * ***##  *  * **
##    3 # * *    ** 
 *     *   p * #    
#* # ##*       *   #