35 20 20
  *   **   #*  **   
  *# *  **   * * 2  
#   * * *   *#   *  
  * # *  ** 2   ##* 
   *#***  **       *
   * ***    #* *   *
* *  ** * # *##*  *#
   2 **   #  *   #  
 1 *  # #  **    * *
 *#** *  #*  #  #  *
# #* **     *    * *
  *#   #  ##* #  ** 
#  #     ###  *     
*  ** #   *### *    
    #  *# *   *    1
#*3  * ##* * *  *   
      #  * *  * *#  
 *  * * *  *   * #2 
#**1 #*  #      3  *
     ** 2 *# p     #