2 20 20
##  #* * # ** *   * 
# *   p   * *# *#  #
## *      *  *   #  
*  #   ##   #**  #  
   *   **  #  ##*   
# #  *      *  #  #*
*       *  *     * *
     * #*#* *  *#   
   #  2   #  #** * #
#* **#   * *      * 
  3 ***  1*      # *
*   # *  * #        
*   *   *  ** *  ** 
#**  *# ** #**    * 
 *   * # *     * *# 
   #*** **    *#*#
* *   **   * * ## * 
         **     # **
 *   *  #    *   *  
  **  *  #***# #   *