51 20 20
  #* **   ***  *  * 
 *    *  * ###      
 * *# #      ** *# #
*   ***#* #   **    
 p   **    *   #**  
 *    **      #*#   
   *   1 * ##2 * *  
*  *#   #*#*   2  * 
* *      * #* #  **#
    *#   ##  # * *  
##*   2* #    *#    
 *# #* *  * *3  * **
**#   **2  *  #   * 
**  *#*       1 #** 
   # *  #  *#* *    
# *  # #* **   **** 
   # **  #    **    
*  *     *1  *##    
    #  **#   3   *# 
  * # #    *    2 **