769 20 20
       ***# # 2  *  
* * *  *   * * # 3 *
 * 3 #**#   *  #*   
     *# #*3  *#*    
2    2   *  #* *3   
  * * **#  *   * * *
   1   #  # #   # #*
  * *#*# **  **3    
#**    1 **  #  **# 
 #   **     3***# 3 
#   #   ****   3 * *
 *   3  #  2 *# ##**
*    * 1#   *      *
  *#* # *#2  * ### *
   p  * *      * ** 
  *   *    #*1  1 # 
*  ** *###  #   *  *
  #** *#  * #   #   
 * *  #***  ** #*3 *
  *  * * #        #*