76 20 20
 #  #*  #   *   *  *
 *   *** *  #**   *#
*      #  *  * # **#
  #  #*        *#* #
       **   # #*   *
**** ** 2 **   #  * 
# #*  #  *#***   *  
  * *# *    *  * * *
*  2*      #* #  *# 
#1     *#  **       
  **   **# # 2 *##* 
** *3 ##*#1     *   
 *    *#       #* * 
     *    * **      
###  *#  1**#*    **
*  * 2          #*  
       # * **    # #
*** p * * #   **# # 
 *     # *#3 ***   *
 # #*     *      2 *