9 20 20
*    #****  ***  *  
   *     * 2* #*    
##**# 3  *  * **** *
#  #* *   #  2  *  #
* **  *  2##*  * #  
***#*  *  # *#*  *  
  *  *  *### #**##* 
  ## 3   *      *##*
#   *        #   #  
*   ##* * *     *  #
        *** ##  *##*
*    * *# ** *#  #  
#* #     *   *      
 **  **1          * 
     *    *       **
  1  p  ##  *       
        ** *       #
      *2 #* **#*  * 
* ** *       * **# #
*     * * **  #  ##*