444 20 20
# #   ** #**  #* ##*
   * **   ## #*  *  
 * * ** ** *   2   2
 #*  # *  ***    *  
  ** *   *   1   #  
  #**   **2   #1 #**
   *****   * *  ## *
 ##*    #   * 3 * 3 
  #   3*  *3   #  * 
*#     #**      *   
   #  #    # #    1 
* *  3## **  *p #*  
*  #  *   **   *   1
      ****# * #***# 
  * #  **# * 3 * #  
2 #   *      # *# * 
    #* 2     *    * 
  * *****#*1    3*  
#***  3 **#  3#  ** 
 *  3  #  ##   *  #*