47 20 20
  ** *  2  #   # ** 
# **  #       #*  # 
*    **1 # * *     *
**    * *   *  * *  
 *  *  #  # # *     
   #  # # *# # 3* * 
  #* # # ##     **  
    *   #*** * # * *
* 2    #   *** #*#  
 ## 2   * *  *   *  
     *    #2 * 1  **
  **    ##   #*   # 
    *   *  ***    * 
 #** #     *  * *# *
* * *# #* *  p  * **
 ##  *1 *  ** **   *
 *  2  #* # **  ### 
*     *  * *   #* 3 
  *  *# *  *        
*#**#   #*   * **  #