93 20 20
 *#     *     * #* *
   ***    * **** ##*
# **   *   1   *   *
** *#   2  #    #  #
#   * # *#  #**  *# 
     *  **   *   ** 
* *2      * **   * *
#    1* * #   * * # 
 # **  3 *  3#** * *
 * # **        *    
2   **  ***2      # 
  *  * *  #   # #*  
  *#* #  ** *   #* #
p  *   * #    #* 1  
  #** # * *    #  **
  *     * * # *** * 
 * *     *# #  ## # 
 # # # #2 #         
* #* *    #*  * #* #
  ** *  **# #       