13 20 20
*  **  * # *   *   #
  ** * ** 2   *    *
 *####       * * *# 
  #  #    *         
 **#     ** #* ** #*
 #    * #* p **    *
  ##*   * *  **1 *  
*  ****     *    * *
 2  * * 3 *     * # 
   #  #  *  ##*  # #
 *****  *  3*  **# *
  ##  **    #*    #*
      * * ***  2 *#*
* *  #   *        #*
  #  # * ***   #  #*
 #* #   #  *#  2  2 
*  *  * *  *    #  *
*       *    1   *##
  **1  *     * *  * 
  ** # ### #   #  ##