394 20 20
# 1 *#      **  **#*
*  *   #  2    *    
 3 * ** # **  #  *  
 ## *#  ** *     ** 
#      *   p  * 3  *
  **##*  *   3    2 
#   3  *#* #   * * *
 *#  # *#**  *  # * 
 *  #* * * **** *# 2
**  # **2   *# # *  
  *#*#    *##   *   
 *  3   ### # #   **
  *   1 # #    * 2  
 1** #   *#***3  #  
*   *   # *    #*#**
  * * *  1    #  # *
   3   *     * *  ##
  * **3   3 * #*  # 
 *# ** #  *  *  3   
   **   1 *   #*****