164 20 20
*   #  ****#### **  
     * #*  #  *   # 
  2 #  * #   #  **  
1    3 ** # 2##* #**
    *      #     #* 
*#**  #*  3*  * *   
*#*##3 *   **#* 2 # 
#   *  # 3  1    ** 
# **  #  *    ## *  
*** *    *3 *  **   
** 3  ***#  **   1 *
#*   *   * * ** *  *
     *p  ***#   **##
**#    * # 2   *    
    1    *   # **3  
    #  ##  **  *  * 
3 *  *    *  * #*   
 *  * * 1 * # 3   #*
  2  3#  ** * *#**##
   ##     *  *   *  