83 20 20
   *       # **  *  
    *  1   *   1 #  
  **#    * ***   # *
#*  * ** *##*  **  #
   **  #    *2    * 
   #  *     *  3    
 #* # *     2    # *
    #   #***    ** #
# *  * #  ** 2#    *
      **  *    *  p 
 * ****  #   #** *  
   **#  #  * ##* ** 
     ** ****    **  
 *1   #  *   * ## **
      2 ###* *  *##*
*#** * **    *  #**#
*   *#*     *  ** * 
 *    #**# *  # ##  
 3  2  # *##  * # # 
*      *#     #*   #