84 20 20
* #*    #*** **     
**   1  #    # *#   
 2 # # * *      * # 
*   *    *##*    * *
  3  #  # ###  ##*2 
 #*  * #  *  #2 *  *
* * #* **   ** *# **
*   *# #*#**  * *   
  # **   *  # *  ** 
*      #  * *2  #  #
   **  *      * * **
 *#  2 **   * *     
*  1    *# #    *  *
#*    * *  #  **#   
# *  #*  # * p      
#  *          *#   *
 ** *  *### **  *   
 * #    **    #*   *
 #    1 * 3 * #*    
* * **    #  ** #  *