40 20 20
 * *# #   * * 2 *   
   *# *   * #  #  * 
*  **#  1 *# #* *  *
* 2 *** * *#    # *#
 #  * #  * #*## # * 
  *      # #  * **  
   #  # * * 2  p** #
       #  #*#     2 
 *    #    *  # 2  *
*   *****  ***#  #* 
  * # #   3    #    
*   3 #  *         *
      * 1   ** # *##
* *# *   * ***#***  
    * ****  *  *   *
  *      *# # ##**##
  **#* #*  * *  * **
 *    ** *    *#   #
 *     *     **     
   *#    **  #  1   