38 20 20
 * #  *   # * **#   
  # *# # * 3 ##* *  
*  * * * *      #*  
 *         *   * ** 
     *# #*  **  #*# 
*     * ##  *  *#   
  *  *           p##
          **1  ** **
 *    #  2 *  **  # 
   1  # # *   #  #* 
*    ** **#   1 *#  
*  #*#*      *  * *#
   #  *#*  *   #** *
*# *# *#   #   *# 3*
  *  #  **** 2#*   *
   ** *  * #    #* *
* # *  **#   *   *  
 2  #*  # 2  # *2 # 
  *  * * **  #*    *
  * **    * **#   # 