902 20 20
*#     #  3 # #* # *
 *  1 **3  #*     **
 *  *#** *  *# ** # 
 *# * *  * *  #   * 
     **** #*   2*# *
**1  # #    **# * 2 
    # 3* * *   * *# 
 *#*   #* 2  3 # *  
*   * ##   *   *3  *
 p   *  3#*  *    3 
  # *      1 * #  * 
 * 3 #  ## *   * * #
   * # * **  # *#*# 
    #**    #*#*  *  
 2 * *  *1 *  #  *#*
     ***  * 2 **   *
  *  *  **#* #* 3  #
* #3   *#     *# *# 
     **#  *    #    
  1         **#  *#*