153 20 20
      *#  *#*   *#**
2  **# 3  *  * * #* 
    *#   #  *   3** 
 1 **#    3 *# *  # 
*  *  ##    * 2   *#
*  1  **#        2  
 *      #* *    #* #
#     * 3   *     # 
 3   #     *   1* # 
* **#  1# * *#  *# p
  *# *  * * *#  **# 
* *** * #  ##** #** 
#      ##***  3 * *#
     *##   **   ## *
**#*    #***  * **  
* 2  *** 3  #  3 # *
   *   3  *   # *   
 1      *  *    * * 
* *  2#*  ** #3 #   
*  *  *** *  *   ##*