748 20 20
#  1   *   *  #    *
 *#    **    **** 3 
#  *2 * ##*3    *** 
 **     ***  #    **
* * * *   #  ****   
* * # ** 1  **  * * 
*#**  *      ###*3 *
 3  * # *  *#  #    
*   * * * # *2   #**
*    p*       * 2* #
 * ** # # *  *   *  
1   #* 3*##** * #   
   **#   *# # * *   
  #*  *  ##3 #   ** 
    # *3  #   #    *
#    3  *   *  *  2 
 #   # #*  3  *  ** 
1 * 1##  2 *  ### *#
  *  * #   # #  # **
*   ***  * #   3    