53 20 20
 #  *** #   #*    * 
*  #*     #  #   * #
#  3    **  *#* #** 
### *      **   ** #
#        **  * *#* #
  * 1*   *     # *##
#*     ** 2 #*  *   
    *2    * *  2   #
*  ** # #*#  1# *  #
 * *** *    *    *  
   *   *      ** ** 
* 3  *     #  ** #* 
**    *    ## * * #*
   * # #  #*# *  * *
   #*  *#p  * #   2 
 * * #**  *       * 
 * **   *#  **      
#    **2 *  1 #  ** 
  **#    * # * *    
#  #*** * # *      #