22 20 20
* 2  *#   # ***# #  
      * *# *** #  **
** 1# *  ****** *   
 3     #   #   ** * 
  * *##   #     * * 
 **   * * *    * * #
 *****#  *#   *# *  
   ** *  #     # *  
  p    *   #*  * #2 
 #  #*##     * #*   
 # * **    *##      
    *  #*# *  **  * 
  * *    ** *#   # *
 **# * ##*  *    #  
#*#      *    #*3  2
# ***   *     ## ## 
  *   #* * #      * 
*  *    1#* *       
 1* #      *  *    *
* *#  *  2  2 * #* *