86 20 20
* *  #       #** *  
*#* *  * # #** *  *#
       ## ##   *#   
# 1 # *# * #     *3 
 **###***** * #*2  *
   #  *  # * 2 *  # 
# ***     * ** **#  
##       ** 1     *#
**** *  * #   * *  *
  * #  # * # #   #**
  **       * * ##*  
 * # #    #* *2  * *
    # *p   **   # #*
 *   *  #* #   *    
  1     *         3 
   *  * * * *  * * #
   * ****      *  * 
   # ###  *   *   # 
  2    ***** 2 ** * 
     *    #     **  