559 20 20
#   *# #** #   #    
  *1 * *# ** #  *##*
 *  ** * 3   ##  *# 
     * ### *  ##   2
  3  * ** 2*#3  3   
    #*  *   # *     
* #   #  2 *# *  *#*
***#*** **  # * **  
   *** #* **# *  * *
 * *   * 1  * # 3 * 
      **    ** * *  
3 * # * *# #*  *  * 
  ##       * *2 * * 
* *  #  3   1  *   #
  *  *  * # *  * #  
* ** * *  #   # 3* *
  * * 3 #   3*    * 
#* p #       *#* *  
  *  ##*1 #  * *2  *
  **   #   1 #   #  