949 20 20
 *     # ** * *    #
 * #### *   *  ## * 
3    *  #3   * ** * 
 *  #**     *      *
 *# *  3** *  # * **
** # #  *  * 1  #   
 *3    * **   *#* 1 
##  *  *1  *  * **#*
     #*   #  3##    
 #   #   # **  *#**#
   1  p  *      *  *
**  * *  # *#     # 
 **# #* *##  *#**3  
3   3 * *  1       *
 #   **  2 ***    ##
  2 * *2 * *  2# 2* 
 *  *   *  *   *   *
 *# # *  # ***#  *  
*  ** #  *#  * * ## 
* ** 3  3 *      ## 