4 20 20
   1 *        *    #
 2* *  *     #*  *# 
  *  ## * * * # #*  
#   **#    *        
*  # **** *   *   # 
* * *# **  *# * #   
    # #     #   #***
 #   #*  *  #* *  **
*  1   * * ##  # #  
*  *  #*  *   *  * *
  * # *    #3    *  
*   *    #*#    # 2*
    # #  *   # ##   
  1* *    **  * *#  
    *      ***#*  * 
*# *        * #     
   **#  **  * ** *# 
*#   **  * ***# *** 
   * *# **   *#   * 
 #  #* p  *##*** 2  