33 20 20
 **#  *  *    * *   
  *# *       2     *
 *#     #*3  *  ** #
#   #*   * *   *  * 
    *  * p  #*  #*#*
 *  ** **     #  *# 
 **  ***#* *  1 *  #
*              *** #
  # *  * 2* *# *  *#
 **#  * #      ** # 
*##*3    * ** *  #  
# 1   2*   ****     
     #     *  2  *  
# **    * * *     **
   *#   #      #  #*
 1   # *  # **   ** 
 *    * #  ## #     
* *   #**** # #* *##
   *2  *  ***** #*  
#  #    ## *##   #* 