364 20 20
* * **    **  *   **
   2 ** 3 * *   2#  
*##  # #**## **    #
* *  * #*   *** #*# 
**#** ##**   * * #  
     **  * #  #    3
* 3* *#  ** * 3  *  
   * ***  #  # * #* 
 *  **   * #* *  # *
      # 3 **#**  *  
* 3   *    3 * *  * 
# * 1  2 *    3 * **
   ** # * ##  *  # #
 2      **  1  # #  
  *# # 1* **    *   
**  *      ##  # 3# 
 *3  #*   p  * *#  1
 * *  ##  * #   *   
   1 *#  2 # *   * #
*#  #  * *#         