840 20 20
# *    # **#*  # ** 
 3 **3  *    *     #
  **  # ***  * * *# 
   3 #  #   #    # #
 *  *## #*   3 *   *
*   *#** ##  * #*  *
*  3 * #   * * #** *
  #   3 **  1 **  * 
* * *#  *#    *     
   # ##*#  p  * 3 **
#*3 * *  1  * *     
**   # * #   #**    
 2 #  1 * # 3    2# 
   # *# * *     * ##
   2 # * #   * 2**  
***        # *   #  
*   2 * ***#*   *  1
*3 **   **   **  *  
*   *  *#*# * * * *#
  #*  #  * *   1   #