50 20 20
#   #  1 #  #*#  #  
   *#** *#  #       
 # **    * **** * 1 
1   *2  **# * *  * *
  **     # #     *  
   #** #* 3   *2 ***
 # * p     #  *   **
    #  *  *# *     #
*#     * #    *     
#*     * * ** *** # 
  **       *   #**  
 **** *#   * ** **  
  #* *  # **#   #   
* **   #* # *  # *  
  #**    *** #*  2 *
       * *    *    *
 #2  *#    #*     * 
    3  #####    2 # 
*  **  *  **  * **#*
   #**# *  ##    #  